# comments start with #, but # must be first non whitespace in line
name : patchyA
000000000000000
000000000000000
000022203330000
000022203330000
000022203330000
000022203330000
000022203330000
044411111114440
044411111114440
044411111114440
044411111114440
044411111114440
044411111114440
044411111114440
044411111114440
+
000000000000000
000000000000000
000000000000000
000000000000000
000000000000000
000000000000000
000000000000000
000000000000000
000000000000000
000000020000000
000000000000000
000000000000000
000000000000000
000000000000000
000000000000000
*
